111111111111111111111111111111111111111
1                  1 5 2          22221
1               3  1   2          22221
1                  1   2          22221
1            11111111111111111111112221
1                                     1
1                                     1
1                                     1
111111111111      221111111111111     1
1                 22                  1
1                 22                  1
1                 22                  1
1                 22                  1
1      11111111111112      111111111111
1                 111                 1
1                 212                 1
1                 212                 1
1 6             222212       1111111111
1               222212                1
11111111       222222                 1
1              225 22                 1
1 7            22  22                 1
1              222222        1111111111
1              222222                 1
1              222222                 1
1     111111111212222                 1
1              21111111111            1
1              22                     1
1              22                     1
1              22                     1
1              22     11111111111111111
1     11111111112                     1
1                                     1
1                                     1
1                                     1
122211111111111111111111              1
12222     2   1                       1
12222     2   1    4                  1
12222     2 5 1                       1
111111111111111111111111111111111111111