111111111111111111111111111111111111111
12 5 2          2222                  1
122222          2222  3               1
122222          2222                  1
1222221111111111111111111111       2221
1                                     1
1                                     1
1                                     1
111222211         2222221122          1
1                 22                  1
1                 22                  1
1                 22                  1
1                 22                  1
1      11112222211112      111111111111
1                 111                 1
1                 212                 1
1                 212                 1
1              222212     222222222   1
16             222212     22222       1
1111111                    222        1
17                          22        1
1                                     1
1                            1111111111
1              222222                 1
1              222222                 1
1          1111212222                 1
1              21111111111            1
1              22                     1
1              22                     1
1              22                     1
1              22        11111222211111
1     11222211112                     1
1                                     1
1                                     1
1                                     1
122211111111111111111111              1
12222     2   1                    22 1
12222     2   1    4               22 1
12222     2 5 1                    22 1
111111111111111111111111111111111111111