111111111111111111111111111111111111111
1                  1 5 2222           1
1               3  1   2222           1
1                  1   2222           1
1            11111111111122222221111111
1                                     1
1                                     1
1                                     1
111111111         2211112222222       1
122222222         22    2222222       1
122222            22      222         1
122               22                  1
12                22                  1
1      11111111111112      111111111111
1                 111                 1
1                 212                 1
1                 212                 1
1                                     1
16             222222222222           1
11111111       22        22           1
17             22   5    22           1
1              22        22           1
1              222222222222           1
1                                     1
1              222222                 1
1       11     11  11   11       111111
1              11                     1
1              22                     1
1              22                     1
1              22                     1
11111111       2211        1111       1
1              22                     1
1                                     1
1                                     1
1                                     1
122211111111111111111111              1
12222     2   1                       1
12222     2   1    4               22 1
12222     2 5 1                    22 1
111111111111111111111111111111111111111